0101000000000000
0010000000000110
0011000000000111
0110000000000000
0000000000000000
0000000000000000
0000000000000000
0000000000000001